47 47 47 47 47 47 47 47 47 47 47 47 47 47 47 47 47 47 47 47 47 47 47 47 47 47 47 47 47 47 47 47 47 47 47 47 47 47 47 47 47 47 47 47 47 47 47 47 47 47 
47 47 47 47 47 47 47 47 47 47 47 53 53 47 47 47 47 47 47 47 47 47 47 47 47 47 47 47 47 47 47 47 47 47 47 47 47 47 47 47 47 47 47 47 47 47 47 47 47 47 
47 47 47 47 47 47 53 53 53 53 53 49 48 53 53 53 53 47 47 47 47 47 53 53 53 53 53 53 53 47 47 47 47 47 47 47 47 47 47 47 47 47 47 47 47 47 47 47 47 47 
53 53 53 53 53 53 49 1 1 1 1 1 1 1 1 1 48 53 53 53 53 53 49 1 1 1 1 1 48 53 53 53 53 53 53 53 53 53 53 53 53 53 53 53 53 53 53 53 53 53 
46 46 1 1 1 1 1 1 1 1 1 1 1 1 1 1 1 1 1 1 1 1 1 1 1 1 1 1 1 1 1 1 1 1 1 1 1 1 1 1 1 1 1 1 1 1 1 1 46 46 
46 46 1 1 1 1 1 1 1 1 1 1 1 1 1 1 1 1 1 1 1 1 1 1 1 1 1 1 1 1 1 1 1 1 1 1 1 1 1 1 1 1 1 1 1 1 1 1 46 46 
46 46 46 46 1 1 1 1 1 1 1 1 1 1 1 1 1 1 1 1 1 46 1 1 1 1 1 1 46 46 1 1 1 1 1 1 1 1 1 1 46 46 46 1 1 1 1 46 46 46 
46 46 46 46 46 46 1 1 1 1 1 1 1 46 1 1 1 1 1 46 46 1 1 1 1 46 46 46 46 46 46 46 1 1 1 1 1 1 46 46 46 46 46 46 46 46 46 46 46 46 
46 46 46 46 46 46 46 46 46 1 1 1 46 46 46 46 1 46 46 46 46 46 1 1 46 46 46 46 46 46 46 46 46 1 1 1 46 46 46 46 46 46 46 46 46 46 46 46 46 46 
46 46 46 46 46 46 46 46 46 46 46 46 46 46 46 46 46 46 46 46 46 46 1 1 46 46 46 46 46 46 46 46 46 46 46 46 46 46 46 46 46 46 46 46 46 46 46 46 46 46 
13 13 13 13 13 13 13 12 46 46 46 46 46 46 46 46 46 46 46 46 46 46 46 1 46 46 46 46 46 46 46 46 46 46 46 46 46 46 46 1 1 1 1 1 46 46 46 46 46 46 
46 46 46 46 46 46 46 4 46 46 46 46 46 46 46 46 46 46 46 46 46 46 46 1 46 46 46 46 46 46 46 46 46 46 46 46 46 46 46 1 1 1 1 1 46 46 46 46 46 46 
46 46 46 46 46 46 46 4 1 46 46 46 1 46 46 46 46 46 46 46 46 46 1 1 1 46 46 46 46 46 46 46 46 46 46 46 46 46 46 1 46 46 46 46 46 46 46 46 46 46 
46 46 46 46 46 46 46 3 13 13 13 13 13 10 13 13 13 13 13 13 13 13 13 13 13 13 13 13 13 13 13 13 13 13 13 13 13 13 13 12 46 46 46 46 46 46 6 13 13 13 
46 46 46 46 46 46 46 46 46 46 46 46 1 4 46 46 46 46 46 46 46 46 46 46 46 46 46 1 1 46 46 46 46 46 46 46 46 46 46 4 46 46 46 46 46 46 4 46 46 46 
46 46 46 46 46 46 46 46 46 1 1 46 46 4 46 46 46 46 46 46 46 46 46 46 1 1 1 1 1 1 1 46 46 46 46 46 46 46 46 4 46 1 1 46 46 46 4 46 46 46 
46 46 46 46 1 1 1 1 46 1 1 1 46 4 46 46 46 46 46 46 46 46 46 46 1 1 1 1 1 1 1 1 1 1 1 46 46 46 46 3 10 13 13 13 13 13 2 46 46 46 
46 46 1 1 1 1 1 1 46 46 1 1 46 4 46 46 46 1 46 46 1 1 1 1 1 1 1 1 1 1 1 1 46 46 46 46 46 46 46 46 4 46 46 46 46 46 46 46 46 46 
46 46 1 1 1 1 46 46 46 46 1 1 1 4 46 46 46 46 46 46 46 46 1 46 46 1 1 46 46 46 46 1 1 1 1 46 46 46 46 46 4 46 46 46 46 46 46 46 46 46 
46 46 1 1 1 46 46 46 1 1 1 1 1 4 46 46 46 46 46 46 46 46 1 46 1 1 46 46 46 46 46 46 46 46 46 46 46 46 46 46 4 46 46 46 46 46 46 46 46 46 
46 46 46 46 1 1 1 1 1 1 1 46 46 4 46 46 46 46 46 46 46 46 46 46 46 46 46 46 46 46 46 46 46 46 46 46 46 46 46 46 4 1 1 1 1 46 46 46 46 46 
46 46 46 46 1 46 46 1 1 1 46 46 46 4 46 46 46 46 46 46 46 46 46 46 46 46 46 46 46 46 46 46 46 46 6 13 13 13 13 13 2 1 46 46 1 1 1 46 46 46 
46 46 46 46 46 46 46 1 46 46 46 5 13 7 13 13 13 13 13 13 13 13 10 13 13 13 13 13 13 13 13 13 13 13 2 46 46 46 46 46 46 46 46 46 1 1 1 46 46 46 
46 46 46 46 1 1 1 1 46 46 46 46 46 46 46 46 46 46 46 46 46 46 4 46 46 46 46 46 46 46 46 46 46 46 46 46 46 46 46 46 46 46 46 46 1 1 1 46 46 46 
50 50 50 50 50 50 50 50 50 50 50 50 50 50 50 50 50 50 50 50 49 46 4 46 48 50 50 50 50 50 50 50 50 50 50 50 50 50 50 50 50 50 50 50 50 50 50 50 50 50 
47 47 47 47 47 47 47 47 47 47 47 47 47 47 47 47 47 47 47 47 49 46 4 46 48 47 47 47 47 47 47 47 47 47 47 47 47 47 47 47 47 47 47 47 47 47 47 47 47 47 
47 47 47 47 47 47 47 47 47 47 47 47 47 47 47 47 47 47 47 47 49 46 4 46 48 47 47 47 47 47 47 47 47 47 47 47 47 47 47 47 47 47 47 47 47 47 47 47 47 47 
47 47 47 47 47 47 47 47 47 47 47 47 47 47 47 47 47 47 47 47 49 46 4 46 48 47 47 47 47 47 47 47 47 47 47 47 47 47 47 47 47 47 47 47 47 47 47 47 47 47 
47 47 47 47 47 47 47 47 47 47 47 47 47 47 47 47 47 47 47 47 49 46 4 46 48 47 47 47 47 47 47 47 47 47 47 47 47 47 47 47 47 47 47 47 47 47 47 47 47 47 
47 47 47 47 47 47 47 47 47 47 47 47 47 47 47 47 47 47 47 47 49 46 4 46 48 47 47 47 47 47 47 47 47 47 47 47 47 47 47 47 47 47 47 47 47 47 47 47 47 47 
53 53 53 53 53 53 53 53 53 53 53 53 53 53 53 53 53 53 53 53 49 46 4 46 48 53 53 53 53 53 53 53 53 53 53 53 53 53 53 53 53 53 53 53 53 53 53 53 53 53 
49 21 21 21 21 21 21 21 21 21 21 21 21 21 21 21 21 21 21 21 21 46 4 46 21 21 21 21 21 21 21 21 21 21 21 21 21 21 21 21 21 21 21 21 21 21 21 21 21 21 
49 46 46 46 46 46 46 46 46 46 46 46 46 46 46 46 46 46 46 46 46 46 4 46 46 46 46 46 46 46 46 46 46 46 46 46 46 46 46 46 46 46 46 46 46 46 46 46 46 46 
49 46 46 46 46 46 46 46 46 46 46 46 46 46 46 46 46 46 46 46 46 46 4 46 46 46 46 46 46 46 46 46 46 46 46 46 46 46 46 46 46 46 46 46 46 46 46 46 46 46 
46 46 46 46 46 46 46 46 46 46 46 46 46 46 46 46 46 46 46 46 46 46 4 45 45 4 65 65 65 65 65 65 65 65 65 65 65 65 65 65 65 65 65 65 65 65 65 65 65 65 
46 46 1 1 44 1 1 15 1 1 44 1 1 15 64 1 1 44 1 1 15 1 4 45 45 8 13 13 13 13 13 13 13 13 13 13 13 13 13 13 13 13 13 13 13 13 13 13 13 13 
46 46 1 37 36 38 1 15 1 37 36 38 1 15 64 1 37 36 38 1 15 1 4 45 45 4 1 46 46 46 46 46 46 46 46 46 46 46 46 46 46 46 46 46 46 46 46 46 46 46 
46 46 1 40 39 41 1 15 1 40 39 41 1 15 64 1 40 39 41 1 15 1 4 45 45 4 46 46 46 46 46 46 46 46 46 46 46 46 46 46 46 46 46 46 46 46 46 46 46 48 
46 46 1 42 35 43 1 15 1 42 35 43 1 15 64 1 42 35 43 1 15 1 4 45 45 4 46 46 46 46 46 46 46 46 46 1 54 54 54 54 54 54 54 46 46 46 46 46 46 48 
46 46 1 1 4 1 1 15 1 1 4 1 1 15 64 1 1 4 1 1 15 1 4 45 45 4 46 46 46 46 46 46 46 46 46 46 54 20 64 44 64 20 54 46 46 46 46 46 46 48 
46 46 54 54 4 54 54 15 54 54 4 54 54 15 54 54 54 4 54 54 15 1 4 45 45 4 46 46 46 46 46 46 46 46 46 46 54 20 37 36 38 20 54 46 46 46 46 46 46 48 
46 46 13 13 7 13 13 13 13 13 7 13 13 13 13 13 13 7 13 13 13 13 0 13 13 7 12 46 46 46 46 46 46 46 46 46 54 20 40 39 41 20 46 46 46 46 46 46 46 48 
46 46 46 46 46 46 46 46 46 46 46 46 46 46 46 46 46 46 46 46 46 46 4 19 19 19 4 46 46 46 46 46 46 46 46 46 54 20 42 35 43 19 54 46 46 46 46 46 46 48 
46 46 46 46 46 46 46 46 46 46 46 46 46 46 46 46 46 46 46 46 46 46 4 19 62 19 4 46 46 46 46 46 46 46 46 46 54 64 64 4 64 64 54 46 46 46 46 46 48 50 
50 50 49 25 1 22 22 22 32 46 46 22 34 34 34 34 34 34 34 34 33 46 4 19 19 19 4 46 46 46 46 46 46 46 46 46 54 54 63 4 63 54 54 46 46 46 46 46 48 53 
47 47 50 50 50 50 50 50 50 50 50 50 50 50 50 50 50 50 50 49 31 46 8 13 13 13 7 13 13 13 13 13 13 13 13 13 13 13 13 7 13 13 13 46 46 46 46 46 46 46 
47 47 47 47 47 47 47 47 47 47 47 47 47 47 47 47 47 47 47 50 50 50 50 50 50 50 50 50 50 50 50 50 50 50 50 50 50 50 50 50 50 50 50 50 50 50 50 50 50 50 
47 47 47 47 47 47 47 47 47 47 47 47 47 47 47 47 47 47 47 47 47 47 47 47 47 47 47 47 47 47 47 47 47 47 47 47 47 47 47 47 47 47 47 47 47 47 47 47 47 47 
47 47 47 47 47 47 47 47 47 47 47 47 47 47 47 47 47 47 47 47 47 47 47 47 47 47 47 47 47 47 47 47 47 47 47 47 47 47 47 47 47 47 47 47 47 47 47 47 47 47 
47 47 47 47 47 47 47 47 47 47 47 47 47 47 47 47 47 47 47 47 47 47 47 47 47 47 47 47 47 47 47 47 47 47 47 47 47 47 47 47 47 47 47 47 47 47 47 47 47 47 
